####################
##_____T____##___###
####___X_#_______###
######_T_##______###
#___TXTT~~##__++__##
#___T_#~~~~##+++++_#
____T_#~~~~~#++++___
#______~~~~##+++___#
#_______~~#________#
___HHHH*HH*HHHHH*___
###__________#######